XXXXXXXXXXXX
XOOOOOOOOOXX
XOXXXOXOXOOX
XOXOOOXOXXOX
XOXXXXXOXOOX
XOOOOCXOXXXX
XOXXXXOOOOXX
XOOOOOOXXOOX
XXXOXXXOXXOX
XOOOXXOSOOOX
XOXOOXXOXXXX
XXXXXXXXXXXX