XXXXXXXXXXXX
XOOOOOOOOOOX
XOOXOOOOOOOX
XOOOOOOOOXOX
XOOOOOOOOOOX
XOOOOOOOOOOX
XOOOOHOOOOOX
XOOOOOOOOOOX
XOXOOOOOOOOX
XOOOOOOOXOOX
XOOOOOOOOOOX
XXXXXXXXXXXX