XXXXXXXXXXXX
XOOOXXOOOXOX
XOHOOOOXOHOX
XOOOXOXXOXOX
XXOXXXOOXOOX
XOOOXOXOOOXX
XOXXOSOXXOOX
XOOOXOXXOOXX
XOXOXOOOXXOX
XOXHXXXOOOOX
XOXOOOOOXXOX
XXXXXXXXXXXX