XXXXXXXXXXXX
XXOXOOOOOXOX
XOSOOXOXOHOX
XXOXXXXXOXOX
XXXOOOOOOXOX
XXXOXOXXOOXX
XOOOXOOXXXOX
XOXHXOOXOOOX
XXXOXXXXOXOX
XOOOOXXHOOOX
XOXXOOOOXXOX
XXXXXXXXXXXX